程序→声明语句 main () 复合语句 函数块
复合语句→{ 语句表 }
语句表→const 常量类型 常量声明表 声明语句 X|变量类型 N 声明语句 X|void 变量 ( 函数声明形参列表 ) ; 声明语句 X|变量 W X|Y X| { 语句表 } X|ε
X→语句表|ε
W→ = 表达式 ;|( 实参列表 ) ;|++ ; | -- ;
表达式→ ( 算数表达式 ) B A C|常量 B A C|变量 D| !布尔表达式 E F| -表达式
D→G B A C| =表达式
C→关系运算符 项 A H|&& 布尔项 F | || 布尔表达式 |ε
H→E F|ε
算数表达式→项 A
A→+ 算数表达式|- 算数表达式|ε
项→因子 B
B→ * 项| / 项| % 项|ε
因子→( 算数表达式 )|常量|变量 G
G→( 实参列表 )|ε|++|--
变量→1|6
常量→ 3 | 2 | ' I| " J
I→1 ' |6 '
J→1 " |6 "
实参列表→实参|ε
实参→表达式 K
K→, 实参|ε
关系运算符→ < | <= | > | >= | == | !=
布尔表达式→布尔项 F
F→ || 布尔表达式|ε
布尔项→布尔因子 E
布尔因子→表达式
E→ && 布尔表达式|ε

声明语句→const 常量类型 常量声明表 声明语句|变量类型 N 声明语句|void 变量(函数声明形参列表);声明语句|ε
N→变量 O
O→P Q|( 函数声明形参列表 );
P→=R|ε
Q→;|, 变量声明表
R→常量|表达式|常量(实参列表);
常量类型→char|int|float
常量声明表→变量=S
S→常量 T
T→;|, 常量声明表
变量声明表→单变量声明 Q
单变量声明→变量 U
U→= 表达式|ε
变量类型→char|int|float
函数类型→char|int|float|void
函数声明形参列表→函数声明形参|ε
函数声明形参→变量类型 V
V→, 函数声明形参|ε
Y→控制语句|return语句
控制语句→if语句|for语句|while语句|do-while语句
return语句→return CC
CC→;|表达式 ;
if语句→if ( 表达式 ) 语句 Z
for语句→for ( 表达式 ; 表达式 ; 表达式 ) 循环语句
while语句→while ( 表达式 ) 循环语句
do-while语句→do 循环用复合语句 while ( 表达式 ) ;
语句→声明语句|执行语句|break语句|continue语句
执行语句→数据处理语句|控制语句|复合语句
数据处理语句→变量 W
循环语句→语句
赋值表达式→变量 = 表达式
循环用复合语句→{ 循环语句表 }
循环语句表→循环语句 AA
AA→循环语句表|ε
循环执行语句→循环用if语句|for语句|while语句|do-while语句|return语句|break语句|continue语句
Z→else 语句|ε
循环用if语句→if ( 表达式 ) 循环语句 BB
BB→else 循环语句|ε
break语句→break ;
continue语句→continue ;
函数块→函数定义 函数块|ε
函数定义→常量类型 变量 ( 函数定义形参列表 ) { 语句表 }|void 变量 ( 函数定义形参列表 ) { DD }
DD→const 常量类型 常量声明表 声明语句 EE|变量类型 N 声明语句 EE|void 变量 ( 函数声明形参列表 ) ; 声明语句 EE|执行语句 EE|ε
EE→DD|ε
函数定义形参列表→函数定义形参|ε
函数定义形参→变量类型 变量 FF
FF→, 函数定义形参|ε